ANR = "cpuntries/American_National_Republic.txt"
BAP = "countries/BayArea.txt"
CAL = "countries/California.txt"
CSD = "countries/Cascadia.txt"
GER = "countries/Greater German Reich.txt"
NCA = "countries/CaliforniaContinental.txt"
OPM = "countries/OregonMilitary.txt"
OSG = "countries/OregonGuard.txt"
USO = "countries/Unit731.txt"
PCD = "countries/CommunistCascadia.txt"
WPG = "countries/Washington.txt"
IHO = "countries/Idaho.txt"
FBH = "countries/FreeBeastsIdaho.txt"
CLG = "countries/CaliforniaGuard.txt"
CLN = "countries/CaliforniaNational.txt"
CRR = "countries/ColoradoRiver.txt"
ELS = "countries/EarthLiberation.txt"
NVM = "countries/NevadaMilitary.txt"
NVR = "countries/NevadaRepublic.txt"
HSD = "countries/Deseret.txt"
ARC = "countries/ArizonaRanger.txt"
NAJ = "countries/Navajo.txt"
ARZ = "countries/Arizona.txt"
NMX = "countries/NewMexico.txt"
SWS = "countries/SouthwestSocialist.txt"
CRD = "countries/Colorado.txt"
GPS = "countries/GreatPlainsSoviet.txt"
FSW = "countries/FreeWyoming.txt"
KKS = "countries/KhakhiShirts.txt"
WNG = "countries/WyomingGuard.txt"
AVD = "countries/AvanteGardeDakota.txt"
FTD = "countries/FreeTerritoyDakota.txt"
SRD = "countries/SocialDakota.txt"
TXM = "countries/TexasMilitia.txt"
TXS = "countries/StateTexas.txt"
OKS = "countries/StateOklahoma.txt"
SQY = "countries/Sequoyah.txt"
TXR = "countries/SecondRepublicTexas.txt"
RGR = "countries/RioGrande.txt"
OKC = "countries/OklahomaCowboy.txt"
FTG = "countries/FreeTerritoryGulf.txt"
LOU = "countries/Louisiana.txt"
DIX = "countries/Dixieland.txt"
BBR = "countries/Blackbelt.txt"
APP = "countries/Appalachia.txt"
SGR = "countries/GeorgiaState.txt"
SFL = "countries/StateFlorida.txt"
GAC = "countries/GrayArmyConfederacy.txt"
GMD = "countries/GulfDistrict.txt"
SRA = "countries/SouthRedArmy.txt"
KKK = "countries/KKK.txt"
